0 0 1 1 0 0 1 1 4 0
0 1 1 1 1 0 1 1 1 5
0 2 3 0 0 0 0 0 0 0
1 6 1 0 1 1 1 1 1 1
1 6 1 0 1 0 1 1 1 1
1 6 1 0 1 0 1 1 1 1
1 6 1 1 1 0 1 1 1 1
1 6 1 1 1 0 1 1 1 1
1 6 1 1 1 0 1 1 1 1
1 6 1 1 1 0 0 0 0 5
